This is what all your training has been for and you're ready.  You can't fail.  You have to reap the harvest tonight.  You've just come from the academy and this is your first solo job.  You've got this.

Grim
A pathetic tale by Jason Lautzenheiser
Release 1 / Serial number 200815 / Inform 7 build 6M62 (I6/v6.33 lib 6/12N) SD
Copyright © 2020, Jason Lautzenheiser.

Sandy Path
The sandy path leading forward is faintly visible in the low light of the setting sun.  Around you is the endless sand of the desert.

>i
You are carrying:
  a robe (being worn)
  a scythe
  a the Official Grim Reapers Handbook

>l
Desert Path
The sandy path leading forward is faintly visible in the low light of the setting sun.  Around you is the endless sand of the desert.

>jump
You jump on the spot, fruitlessly.

>xyzzy
That's not a verb I recognize.

* * *

>i
You are carrying:
  a robe (being worn)
  a scythe
  a the Official Grim Reapers Handbook

>x self
Your face is hidden in your long dark robe, only your eyes glow allowing your harvest to see you in the dark of night.  It is actually just a myth that you're a skeleton inside those robes.  You are just really, really skinny.  And pale, don't forget pale.

* * *

>i
You are carrying:
  a robe (being worn)
  a scythe
  a the Official Grim Reapers Handbook

>drop scythe
It's what makes you who you are, without it you would just be a weird skinny dude in a robe.  Besides, if you come back without it....well let's just say you don't want to test your theories on that.

Dropped.

>l
The Desert Path
The sandy path leading forward is faintly visible in the low light of the setting sun.  Around you is the endless sand of the desert.

You can see a scythe here.

* * *

>i
You are carrying:
  a robe (being worn)
  a scythe
  a the Official Grim Reapers Handbook

>x scythe
The standard grim reaper scythe.  Eight feet long with four foot blade gleaming in the dim light.

>l
The Desert Path
The sandy path leading forward is faintly visible in the low light of the setting sun.  Around you is the endless sand of the desert.

>i
You're holding a scythe. You're wearing a robe.

>x sand
You can't see any such thing.

* * *

>i
You are carrying:
  a robe (being worn)
  a scythe
  a the Official Grim Reapers Handbook

>x handbook
The handbook, titled "Official Rules and Regulations for all Authorized Grim Reapers" is issued to all first year students.

>drop handbook
You're not even sure that is possible.

>i
You are carrying:
  a robe (being worn)
  a scythe
  a the Official Grim Reapers Handbookhandbook

* * *

This is what all your training has been for and you're ready.  You can't fail.  You have to reap the harvest tonight.  You've just come from the academy and this is your first solo job.  You've got this.

Grim
A pathetic tale by Jason Lautzenheiser
Release 1 / Serial number 200815 / Inform 7 build 6M62 (I6/v6.33 lib 6/12N) SD
Copyright © 2020, Jason Lautzenheiser.

Sandy Path
The sandy path leading forward is faintly visible in the low light of the setting sun.  Around you is the endless sand of the desert.

>x me
Your face is hidden in your long dark robe, only your eyes glow allowing your harvest to see you in the dark of night.  It is actually just a myth that you're a skeleton inside those robes.  You are just really, really skinny.  And pale, don't forget pale.

>x robe
Standard issue reaper robe, head to toe coverage.

>about
Grim is copyright © 2014 by Jason Lautzenheiser (jlautz@sssnet.com or visit my blog at http://lautzofif.wordpress.com).  This work may be distributed for free, but not sold or included in any for-profit collection without the written permission from the author.

* * *

This is what all your training has been for and you're ready.  You can't fail.  You have to reap the harvest tonight.  You've just come from the academy and this is your first solo job.  You've got this.

Grim
A pathetic tale by Jason Lautzenheiser
Release 1 / Serial number 200815 / Inform 7 build 6M62 (I6/v6.33 lib 6/12N) SD
Copyright © 2020, Jason Lautzenheiser.

Sandy Path
The sandy path leading forward is faintly visible in the low light of the setting sun.  Around you is the endless sand of the desert.

>drop scythe
It's what makes you who you are, without it you would just be a weird skinny dude in a robe.  Besides, if you come back without it....well let's just say you don't want to test your theories on that.

>i
You are carrying:
  a robe (being worn)
  a scythe

* * *

This is what all your training has been for and you're ready.  You can't fail.  You have to reap the harvest tonight.  You've just come from the academy and this is your first solo job.  You've got this.

Grim
A pathetic tale by Jason Lautzenheiser
Release 1 / Serial number 200815 / Inform 7 build 6M62 (I6/v6.33 lib 6/12N) SD
Copyright © 2020, Jason Lautzenheiser.

Sandy Path
The sandy path leading forward is faintly visible in the low light of the setting sun.  Around you is the endless sand of the desert.

>z
Time passes.

Dink looks at you hatefully.

You are being attacked by Dink J. Bets.

>z
Time passes.

>z
Time passes.

>l
The Desert Path
The sandy path leading forward is faintly visible in the low light of the setting sun.  Around you is the endless sand of the desert.

You can see Dink J. Bets here.

* * *

>z
Time passes.

I beg your pardon?

* * *

>z
Time passes.

Dink looks at you hatefully.

You are being attacked by Dink J. Bets.

>attack self
You are being attacked.

Dink looks at you hatefully.

* * *

This is what all your training has been for and you're ready.  You can't fail.  You have to reap the harvest tonight.  You've just come from the academy and this is your first solo job.  You've got this.

Grim
A pathetic tale by Jason Lautzenheiser
Release 1 / Serial number 200815 / Inform 7 build 6M62 (I6/v6.33 lib 6/12N) SD
Copyright © 2020, Jason Lautzenheiser.

Sandy Path
The sandy path leading forward is faintly visible in the low light of the setting sun.  Around you is the endless sand of the desert.

>l
Sandy Path
The sandy path leading forward is faintly visible in the low light of the setting sun.  Around you is the endless sand of the desert.

>i
You are carrying:
  a robe (being worn)
  a scythe

>x scythe
The standard grim reaper scythe.  Eight feet long with four foot blade gleaming in the dim light.

>; test
That's not a verb I recognize.

>* test
You've made a comment-style command, but Transcript is off. Type TRANSCRIPT to turn it on, if you wish to make notes.

The long version of this nag will only appear once. You may press any key to continue.

* * *

I beg your pardon?

>* test
(Comment not sent to transcript.)

* * *

This is what all your training has been for and you're ready.  You can't fail.  You have to reap the harvest tonight.  You've just come from the academy and this is your first solo job.  You've got this.

Grim
A pathetic tale by Jason Lautzenheiser
Release 1 / Serial number 200815 / Inform 7 build 6M62 (I6/v6.33 lib 6/12N) SD
Copyright © 2020, Jason Lautzenheiser.

Sandy Path
The sandy path leading forward is faintly visible in the low light of the setting sun.  Around you is the endless sand of the desert.

>; test
You've made a comment-style command, but the transcript is off. Type TRANSCRIPT to turn it on, if you wish to make notes.

The long version of this nag will only appear once. You may press any key to continue.

* * *

>;test
(Comment not sent to transcript.)

>* test
(Comment not sent to transcript.)

* * *

This is what all your training has been for and you're ready.  You can't fail.  You have to reap the harvest tonight.  You've just come from the academy and this is your first solo job.  You've got this.

Grim
A pathetic tale by Jason Lautzenheiser
Release 1 / Serial number 200815 / Inform 7 build 6M62 (I6/v6.33 lib 6/12N) SD
Copyright © 2020, Jason Lautzenheiser.

Sandy Path
The sandy path leading forward is faintly visible in the low light of the setting sun.  Around you is the endless sand of the desert.

>;test
That's not a verb I recognize.

>; test
That's not a verb I recognize.

>* tets
That's not a verb I recognize.

* * *

This is what all your training has been for and you're ready.  You can't fail.  You have to reap the harvest tonight.  You've just come from the academy and this is your first solo job.  You've got this.

Grim
A pathetic tale by Jason Lautzenheiser
Release 1 / Serial number 200815 / Inform 7 build 6M62 (I6/v6.33 lib 6/12N) SD
Copyright © 2020, Jason Lautzenheiser.

Sandy Path
The sandy path leading forward is faintly visible in the low light of the setting sun.  Around you is the endless sand of the desert.

>*
That's not a verb I recognize.

>*; test
You've made a comment-style command, but the transcript is off. Type TRANSCRIPT to turn it on, if you wish to make notes.

The long version of this nag will only appear once. You may press any key to continue.

* * *

This is what all your training has been for and you're ready.  You can't fail.  You have to reap the harvest tonight.  You've just come from the academy and this is your first solo job.  You've got this.

Grim
A pathetic tale by Jason Lautzenheiser
Release 1 / Serial number 200815 / Inform 7 build 6M62 (I6/v6.33 lib 6/12N) SD
Copyright © 2020, Jason Lautzenheiser.

Sandy Path
The sandy path leading forward is faintly visible in the low light of the setting sun.  Around you is the endless sand of the desert.

>transcript
Start of a transcript of

Grim
A pathetic tale by Jason Lautzenheiser
Release 1 / Serial number 140515 / Inform 7 build 6L02 (I6/v6.33 lib 6/12N) SD
Copyright © 2014, Jason Lautzenheiser.
Identification number: //DF5CF3AC-7345-4FE8-8267-1655A234B42D//
Interpreter version 0.5.2 / VM 3.1.2 / Library serial number 080126
Standard Rules version 3/120430 by Graham Nelson

Thanks for doing this! Email can go to lautzenheiser.jason@gmail.com.

>quit
Thanks for taking the time to create a transcript.  Please send it to lautzenheiser.jason@gmail.com and I'll be grateful.  Thanks!

Are you sure you want to quit?

* * *

This is what all your training has been for and you're ready.  You can't fail.  You have to reap the harvest tonight.  You've just come from the academy and this is your first solo job.  You've got this.

Grim
A pathetic tale by Jason Lautzenheiser
Release 1 / Serial number 200815 / Inform 7 build 6M62 (I6/v6.33 lib 6/12N) SD
Copyright © 2020, Jason Lautzenheiser.

Sandy Path
The sandy path leading forward is faintly visible in the low light of the setting sun.  Around you is the endless sand of the desert.

>e
Front Stoop
You are standing on the dirt stoop of dinks-home.  A simple roof overhangs this area and a homemade wooden chair sits off to one side of the front door.

>knock
What do you want to knock?

>open door
You can't see any such thing.

>l
Front Stoop
You are standing on the dirt stoop of Dink's home.  A simple roof overhangs this area and a homemade wooden chair sits outside the front door.

You can see a front-door here.

>x dink
You can't see any such thing.

>w
Sandy Path
The sandy path leading forward is faintly visible in the low light of the setting sun.  Around you is the endless sand of the desert.

>w
You can't go that way.

>s
You can't go that way.

>n
You can't go that way.

>x dink
You can't see any such thing.

* * *

>knock
What do you want to knock?

>door
You bang on the front door.  You hear a faint rustling from inside the house.

>rap on door
You bang on the front door again.  Someone from inside yells, "Hold on...hold on already, I'm coming".

>tap on door
You bang on the front door again.  "Geez, this one's impatient", someone mumbles from just on the other side of the door.

Slowly the door creeks open just enough for an old man to peek out. 

"What do you want?" the old man peering out the slightly cracked door asks.

"It's your..."

That came out kind of squeeky.  You clear your throat and try again in a more menacing tone.

"It's your time Dink Betts.  I've come for your soul.

>attack door
Violence isn't the answer to this one.

* * *

>e
Front Stoop
You are standing on the dirt stoop of dinks-home.  A simple roof overhangs this area and a homemade wooden chair sits off to one side of the front door.

>e
(first opening the front door)
Even the Grim Reaper has some manners, it would be impolite to just burst in uninvited.

>l
Front Stoop
You are standing on the dirt stoop of Dink's home.  A simple roof overhangs this area and a homemade wooden chair sits outside the front door.

You can see a front-door here.

>knock
That's not a verb I recognize.

>x door
You can't see any such thing.

* * *

>e
(first opening the front door)
Even the Grim Reaper has some manners, it would be impolite to just burst in uninvited.

>attack front door
Violence isn't the answer to this one.

>knock on door
You bang on the front door.  You hear a faint rustling from inside the house.

You bang on the front door, but you hear nothing inside.

>g
You bang on the front door again.  Someone from inside yells, "Hold on...hold on already, I'm coming".

You bang on the front door, but you hear nothing inside.

>g
You bang on the front door again.  "Geez, this one's impatient", someone mumbles from just on the other side of the door.

Slowly the door creeks open just enough for an old man to peek out. 

"What do you want?" the old man peering out the slightly cracked door asks.

"It's your..."

That came out kind of squeeky.  You clear your throat and try again in a more menacing tone.

"It's your time Dink Betts.  I've come for your soul."

Dink, looks at you with those old squinty eyes and a sly grin creeps across his face.

He let's out a small chuckle and spits his tobacco at your feet just about hitting the bottom of your robe. 

"You'll have to come get it, Mr. Reaper."  And with that he slams the door in your face.

You bang on the front door, but you hear nothing inside.

>attack front door
You swing your scythe at the front door and it disappears in a cloud of dust.

>l
Front Stoop
You are standing on the dirt stoop of Inside Dink's Home.  A simple roof overhangs this area and a homemade wooden chair sits off to one side of the pile of dust.

* * *

>e
Front Stoop
You are standing on the dirt stoop of dinks-home.  A simple roof overhangs this area and a homemade wooden chair sits off to one side of the front door.

>x chair
You can't see any such thing.

>x door
Simple wooden front door.

>open door
It seems to be locked.

>knock on door
That's not a verb I recognize.

* * *

>e
Front Stoop
You are standing on the dirt stoop of dinks-home.  A simple roof overhangs this area and a homemade wooden chair sits off to one side of the front door.

>knock on door
You bang on the front door.  You hear a faint rustling from inside the house.

>knock on door
You bang on the front door again.  Someone from inside yells, "Hold on...hold on already, I'm coming".

>knock on door
You bang on the front door again.  "Geez, this one's impatient", someone mumbles from just on the other side of the door.

Slowly the door creeks open just enough for an old man to peek out. 

"What do you want?" the old man peering out the slightly cracked door asks.

"It's your..."

That came out kind of squeeky.  You clear your throat and try again in a more menacing tone.

"It's your time Dink Betts.  I've come for your soul.

>attack door
Violence isn't the answer to this one.

* * *

>knock on door
You bang on the front door.  You hear a faint rustling from inside the house.

>g
You bang on the front door again.  Someone from inside yells, "Hold on...hold on already, I'm coming".

>g
You bang on the front door again.  "Geez, this one's impatient", someone mumbles from just on the other side of the door.

Slowly the door creeks open just enough for an old man to peek out. 

"What do you want?" the old man peering out the slightly cracked door asks.

"It's your..."

That came out kind of squeeky.  You clear your throat and try again in a more menacing tone.

"It's your time Dink Betts.  I've come for your soul."

Dink, looks at you with those old squinty eyes and a sly grin creeps across his face.

He let's out a small chuckle and spits his tobacco at your feet just about hitting the bottom of your robe. 

"You'll have to come get it, Mr. Reaper."  And with that he slams the door in your face.

>g
You bang on the front door, but you hear nothing inside.

>l
Front Stoop
You are standing on the dirt stoop of Inside Dink's Home.  A simple roof overhangs this area and a homemade wooden chair sits off to one side of the front door.

>attack door
You swing your scythe at the front door and it disappears in a cloud of dust.

>g
You swing your scythe at the remains of the front door and it disappears in a cloud of dust.

>l
Front Stoop
You are standing on the dirt stoop of Inside Dink's Home.  A simple roof overhangs this area and a homemade wooden chair sits off to one side of the remains of the front door.

>take door
You shift through the remains of the front door but nothing is worth taking.

* * *

>e
Front Stoop
You are standing on the dirt stoop of dinks-home.  A simple roof overhangs this area and a homemade wooden chair sits off to one side of the front door.

>attack door
Violence isn't the answer to this one.

>knock on door
You bang on the front door.  You hear a faint rustling from inside the house.

* * *

>g
You bang on the front door again.  Someone from inside yells, "Hold on...hold on already, I'm coming".

>g
You bang on the front door again.  "Geez, this one's impatient", someone mumbles from just on the other side of the door.

Slowly the door creeks open just enough for an old man to peek out. 

"What do you want?" the old man peering out the slightly cracked door asks.

"It's your..."

That came out kind of squeeky.  You clear your throat and try again in a more menacing tone.

"It's your time Dink Betts.  I've come for your soul.

Dink, looks at you with those old squinty eyes and a sly grin creeps across his face.

He let's out a small chuckle and spits his tobacco at your feet just about hitting the bottom of your robe. 

"You'll have to come get it, Mr. Reaper."  And with that he slams the door in your face.

* * *

>e
Front Stoop
You are standing on the dirt stoop of dinks-home.  A simple roof overhangs this area and a homemade wooden chair sits off to one side of the front door.

>take door
As much as it looks like you could rip the door right of the hinges, it is attached better than you thought or perhaps you should have spent more time in physical training at the acadamy.

* * *

>e
Front Stoop
You are standing on the dirt stoop of dinks-home.  A simple roof overhangs this area and a homemade wooden chair sits off to one side of the front door.

>l
Front Stoop
You are standing on the dirt stoop of Inside Dink's Home.  A simple roof overhangs this area and a homemade wooden chair sits off to one side.

>x door
Simple wooden front door.

>e
(first opening the front door)
Even the Grim Reaper has some manners, it would be impolite to just burst in uninvited.

* * *

>e
Front Stoop
You are standing on the dirt stoop of dinks-home.  A simple roof overhangs this area and a homemade wooden chair sits off to one side of the front door.

>x door
Simple wooden front door.

>open door
Even the Grim Reaper has some manners, it would be impolite to just burst in uninvited.

>e
Even the Grim Reaper has some manners, it would be impolite to just burst in uninvited.

>l
Front Stoop
You are standing on the dirt stoop of Inside Dink's Home.  A simple roof overhangs this area and a homemade wooden chair sits off to one side of the front door.

>knock on door
You bang on the front door.  You hear a faint rustling from inside the house.

* * *

>e
Front Stoop
You are standing on the dirt stoop of dinks-home.  A simple roof overhangs this area and a homemade wooden chair sits off to one side of the front door.

>x roof
The tin roof is rusted through in many places.

>x home
The house is little more than some wooden planks standing upright topped with a rusty tin roof.

>x chair
The wooden chair is made up of some branches nailed and tied together to make something roughly chair shaped.

>sit in chair
You get onto the wooden chair.

>l
Front Stoop (on the wooden chair)
You are standing on the dirt stoop of dinks-home.  A simple roof overhangs this area and a homemade wooden chair sits off to one side of the front door.

>u
(first getting off the wooden chair)
You can't go that way.

>l
Front Stoop
You are standing on the dirt stoop of dinks-home.  A simple roof overhangs this area and a homemade wooden chair sits off to one side of the front door.

>x door
Simple wooden front door.

* * *

>open door
Even the Grim Reaper has some manners, it would be impolite to just burst in uninvited.

>knock
What do you want to knock?

* * *

>door
You bang on the front door.  You hear a faint rustling from inside the house.

>knock
What do you want to knock?

>knock door
You bang on the front door again.  Someone from inside yells, "Hold on...hold on already, I'm coming".

>g
You bang on the front door again.  "Geez, this one's impatient", someone mumbles from just on the other side of the door.

Slowly the door creeks open just enough for an old man to peek out. 

"What do you want?" the old man peering out the slightly cracked door asks.

"It's your..."

That came out kind of squeeky.  You clear your throat and try again in a more menacing tone.

"It's your time Dink Betts.  I've come for your soul."

Dink, looks at you with those old squinty eyes and a sly grin creeps across his face.

He let's out a small chuckle and spits his tobacco at your feet just about hitting the bottom of your robe. 

"You'll have to come get it, Mr. Reaper."  And with that he slams the door in your face.

>open door
Even the Grim Reaper has some manners, it would be impolite to just burst in uninvited.

>knock door
You bang on the front door, but you hear nothing inside.

>hit door
You swing your scythe at the front door and it disappears in a cloud of dust.

>l
Front Stoop
You are standing on the dirt stoop of dinks-home.  A simple roof overhangs this area and a homemade wooden chair sits off to one side of the remains of the front doorfront door.

You can see a remains of the front doorfront door here.

>in
You can't go that way.

>e
Inside Dink's Home
You can see Dink J. Bets here.

>l
Inside Dink's Home
You can see Dink J. Bets here.

>credits
Grim is copyright © 2020 by Jason Lautzenheiser (lautzenheiser.jason@gmail.com or visit my blog at http://lautzofif.wordpress.com).  This work may be distributed for free, but not sold or included in any for-profit collection without the written permission from the author.

>get dink
I don't suppose Dink J. Bets would care for that.

>get soul
You can't see any such thing.

>x self
Your face is hidden in your long dark robe, only your eyes glow allowing your harvest to see you in the dark of night.  It is actually just a myth that you're a skeleton inside those robes.  You are just really, really skinny.  And pale, don't forget pale.

* * *

>credits
Grim is copyright © 2020 by Jason Lautzenheiser (lautzenheiser.jason@gmail.com or visit my blog at http://lautzofif.wordpress.com).  This work may be distributed for free, but not sold or included in any for-profit collection without the written permission from the author.

>x dink
Dink J. Bets is an old man, but looks quite spry for his age.

You can always look at your orders for more information on Dink..

>x dink
Dink J. Bets is an old man, but looks quite spry for his age.

>take bets
I don't suppose Dink J. Bets would care for that.

>x soul
Dink J. Bets is an old man, but looks quite spry for his age.

>take soul
I don't suppose Dink J. Bets would care for that.

>t soul
That's not a verb I recognize.

>take soul
I don't suppose Dink J. Bets would care for that.